Algeria,Argentina,Australia,Belgium,Bosnia and Herzegovina,Brazil,Cameroon,Chile,China,Colombia,Costa Rica,Croatia,Cuba,Ecuador,England,Ethiopia,France,Germany,Ghana,Greece,Honduras,India,Iran,Ireland,Italy,Ivory Coast,Japan,Mexico,Netherlands,Nigeria,Portugal,Russia,South Korea,Spain,Switzerland,Thailand,Turkey,United States,Uruguay,Vietnam
8,3,8,4,9,2,10,4,18,9,6,5,7,7,30,27,12,11,13,7,8,70,25,10,3,9,22,7,3,10,4,26,29,5,7,22,6,12,10,33
40,19,34,14,36,27,18,17,84,24,14,37,37,29,218,60,72,107,32,52,31,154,52,104,5,20,87,42,29,42,15,131,91,23,28,63,47,53,15,80
84,224,269,229,79,224,54,216,368,203,207,100,306,146,546,135,327,441,64,300,145,298,96,507,144,55,321,290,221,79,222,266,243,313,290,256,174,320,103,256
45,177,136,181,27,225,27,154,462,121,163,50,288,90,209,132,370,341,34,435,76,290,108,218,438,32,400,517,115,28,177,107,168,401,176,348,136,464,43,240
11,47,36,46,5,69,15,29,226,26,28,14,75,19,51,42,265,134,9,223,14,216,27,64,607,7,236,366,23,5,44,23,48,166,38,242,52,404,8,109
